################################################################################################
#..............................................................................................#
#..............................................................................................#
#...............................................$..............................................#
#....................###.....................####.....................###......................#
#.........$.........................P............................$.............................#
#...............................................C..............................................#
#..................###..............###...................###..............###..................#
#.@............................................................................................#
################################################################################################
